2 2 2 2 2 2 2 2 2 2 2 2 2 2 2 2 2 2 2 2
2 0 0 0 0 0 0 0 0 2 1 2 0 0 2 2 2 2 2 2
2 0 0 0 3 0 0 0 0 2 0 2 0 0 2 2 2 2 2 2
2 2 2 2 0 0 2 2 2 2 0 2 0 0 2 2 2 2 2 2
2 0 0 0 0 0 0 0 0 2 0 2 0 0 0 0 0 0 0 2
2 2 2 2 2 2 2 2 2 2 0 2 0 2 2 2 2 2 2 2
2 4 0 0 0 0 0 4 0 0 0 0 0 0 0 0 3 0 0 2
2 2 2 0 2 2 2 2 2 2 3 2 2 2 2 2 2 2 2 2
2 2 2 0 0 0 0 0 0 0 0 0 0 0 0 0 0 0 0 2
2 2 2 0 2 2 2 2 2 0 2 2 2 0 0 0 0 0 0 2
5 5 0 0 2 0 0 0 2 4 0 0 2 0 0 0 0 0 0 2
2 2 2 2 2 0 0 0 2 0 0 0 2 2 2 2 2 2 2 2
2 0 0 0 0 0 0 0 0 0 0 0 0 0 0 0 0 0 0 2
2 0 0 4 0 0 0 0 2 0 0 0 0 0 0 0 0 0 0 2
2 2 2 2 0 2 2 2 2 0 0 0 0 0 0 0 4 0 0 2
2 0 0 0 0 0 4 0 0 0 0 0 0 0 0 0 0 0 0 2
2 2 2 2 2 2 2 2 2 2 2 2 2 2 2 2 2 2 2 2
2 2 2 2 2 2 2 2 2 2 2 2 2 2 2 2 2 2 2 2
2 2 2 2 2 2 2 2 2 2 2 2 2 2 2 2 2 2 2 2
2 2 2 2 2 2 2 2 2 2 2 2 2 2 2 2 2 2 2 2